{
    "65": "А",
    "66": "В",
    "69": "Е",
    "72": "Н",
    "73": "І",
    "75": "К",
    "77": "М",
    "79": "О",
    "80": "Р",
    "88": "Х",
    "112": "р",
    "120": "х",
    "67": "С",
    "84": "Т",
    "97": "а",
    "99": "с",
    "101": "е",
    "105": "і",
    "111": "о",
    "8216": "'",
    "8217": "'",
    "96": "'"
}